11111111111111111111
1deR3222222222222224
1fga2222222222222QS1
13h32222222222222221
12222222222222222221
12222222222222222221
12222222223222222221
12222222232222222221
12222222232322222221
12222222222222222221
12222222222222222221
12222222222222222221
12222222252222222221
12222222222222222221
12222222222222222221
1DCN222222222222PJK1
1BAO222222223322OLM1
13E322222222222222i1
12222222222222222231
11111111111111111111