00000000000000000000
00000000000000000000
00000000000000000000
00000000000000000000
00000000000000000000
00000000000000000000
00000000000000000000
00000000000000000000
00000033333330000000
0000003II3InI3000000
0000003II3kml3000000
0000003II33i33000000
0000003I5IIII3000000
00000033433330000000
00000000000000000000
00000000000000000000
00000000000000000000
00000000000000000000
00000000000000000000
00000000000000000000