00000000000000000000
00000000000000000000
00000000000000000000
00000000000000000000
00000000000000000000
00000000000000000000
00000000000000000000
00000333333300000000
000003ooIoo300000000
0000033hIpp300000000
000003ooII5E00000000
000003pIIII300000000
000003ooIoo300000000
000003ppIII300000000
00000333333300000000
00000000000000000000
00000000000000000000
00000000000000000000
00000000000000000000
00000000000000000000