00000000000000000000
00000000000000000000
00000000000000000000
00000000000000000000
00000000000000000000
00000000000000000000
00000000000000000000
00000333333330000000
000003rwtIIs30000000
000003qIpIIq30000000
000003pIIIIp30000000
000003II5III30000000
00000333i33330000000
00000000000000000000
00000000000000000000
00000000000000000000
00000000000000000000
00000000000000000000
00000000000000000000
00000000000000000000