00000000000000000000
00000000000000000000
00000000000000000000
00000000000000000000
00000000000000000000
00000000000000000000
00000333433330000000
000003II5III30000000
000003uvIIuv30000000
000003pIIIII30000000
000003IIIIII30000000
000003uvIIuv30000000
000003iIIIpI30000000
00000333333330000000
00000000000000000000
00000000000000000000
00000000000000000000
00000000000000000000
00000000000000000000
00000000000000000000