11111111111111111111
4522222222222222TDC1
1222222222222222bBA1
122222222222232222h1
12222222232222222331
12222222222222222221
12223222223222222221
12222222232222222221
12232222232322222221
12222222222222223ch1
12222222222222223JK1
12222222222222223LM1
12222222222222223331
12222222222222222221
12222222222222222221
12222222222222222221
12222222222222332221
12222222222222222221
12222222222222222221
11111111111111111111