00000000000000000000
00000000000000000000
00000000000000000000
00000000000000000000
00000000000000000000
00003333333330000000
00003IIIIIIF30000000
00003IIIIIIG30000000
0000E5IIIIIw30000000
00003IIIIII330000000
00003IIIIII330000000
00003IIIIII333000000
00000000000000000000
00000000000000000000
00000000000000000000
00000000000000000000
00000000000000000000
00000000000000000000
00000000000000000000
00000000000000000000